[АО ГОИ]	Государственный Оптический Институт им. С. И. Вавилова
[Астраханский ГМУ]	Астраханский государственный медицинский университет
[АФИ]	Агрофизический НИИ Россельхозакадемии
[БашГУ]	Башкирский государственный университет
[БГТУ им. В.Г. Шухова ]	Белгородский государственный технологический университет им. В. Г. Шухова
[БГУ, Белоруссия]	Белорусский государственный университет, Белоруссия
[БГУИР]	Белорусский государственный университет информатики и радиоэлектроники, Белоруссия
[БИН РАН]	Ботанический институт имени В. Л. Комарова Российской академии наук
[ВГУ]	Воронежский государственный университет
[ВМедА]	Военно-медицинская академия имени С. М. Кирова
[ВНИИФ]	Всероссийский научно-исследовательский институт фитопатологии
[ВолгГТУ]	Волгоградский государственный технический университет
[ВолГУ]	Волгоградский государственный университет
[ГАО РАН]	Главная астрономическая обсерватория РАН
[ГЕОХИ РАН]	Институт геохимии и аналитической химии им. В. И. Вернадского
[ДвГУПС]	Дальневосточный государственный университет путей сообщения
[ЖГТУ, Украина]	Житомирский государственный технологический университет, Украина
[ИАП РАН]	Институт аналитического приборостроения РАН
[ИАПУ ДВО РАН]	Институт автоматики и процессов управления ДВО РАН
[ИВС РАН]	Институт высокомолекулярных соединений РАН
[ИМАШ РАН]	Институт машиноведения имени А. А. Благонравова РАН
[ИМЕТ УрО РАН]	Институт Металлургии УрО РАН
[ИМСС УрО РАН]	Институт механики сплошных сред УрО РАН
[ИНХ СО РАН]	Институт неорганической химии им. А. В. Николаева СО РАН
[ИНЦ РАН]	Институт цитологии РАН
[ИНЭП ЮФУ]	Институт нанотехнологий, электроники и приборостроения ЮФУ
[ИОФ РАН]	Институт общей физики имени А. М. Прохорова РАН
[ИПЛИТ РАН]	Институт проблем лазерных и информационных технологий РАН
[ИПМаш РАН]	Институт проблем машиноведения РАН
[ИПМИ КарНЦ РАН]	Институт прикладных математических исследований КарНЦ РАН
[ИПФ РАН]	Институт прикладной физики РАН
[ИРЭ РАН]	Институт радиотехники и электроники имени В. А. Котельникова РАН
[ИСОИ РАН — филиал ФНИЦ Кристаллография и фотоника РАН]	Институт систем обработки изображений РАН — филиал ФНИЦ «Кристаллография и фотоника» РАН
[ИТМО]	Университет ИТМО
[ИТФ РАН]	Институт теоретической физики им. Л.Д. Ландау
[ИФ СО РАН]	Институт физики им. Л.В. Киренского СО РАН
[ИФХЭ РАН]	Институт физической химии и электрохимии имени А. Н. Фрумкина РАН
[ИХТТ УрО РАН]	Институт химии твёрдого тела УрО РАН
[ИЯФ СО РАН]	Институт ядерной физики имени Г. И. Будкера СО РАН
[КазНУ им. аль-Фараби]	Казахский Национальный Университет имени Аль-Фараби, Казахстан
[КГАСУ]	Казанский государственный архитектурно-строительный университет
[КнАГУ]	Комсомольский-на-Амуре государственный университет
[КПИ им. Игоря Сикорского, Украина]	Киевский политехнический институт им. Игоря Сикорского, Украина
[КФУ им. В. И. Вернадского]	Крымский федеральный университет имени В. И. Вернадского
[КФУ]	Казанский федеральный университет
[МГТУ «СТАНКИН»]	Московский государственный технологический университет «СТАНКИН»
[МГТУ им. Н. Э. Баумана]	Московский государственный технический университет им. Н. Э. Баумана
[МГУ им. М. В. Ломоносова]	Московский государственный университет им. М. В. Ломоносова
[МГУ им. Н. П. Огарёва]	Мордовский государственный университет им. Н. П. Огарева
[МГУПП]	Московский государственный университет пищевых производств
[МИРЭА]	Российский технологический университет
[МФТИ]	Московский физико-технический институт
[НИИЭТФ]	Научно-исследовательский институт экспериментальной и теоретической физики при КазНУ им. аль-Фараби, Казахстан
[НИИЭФА им. Д. В. Ефремова]	Научно-исследовательский институт электрофизической аппаратуры им. Д.В.Ефремова
[НИЛСЭ]	Научно-исследовательская лаборатория судебных экспертиз
[НИУ МЭИ]	Московский энергетический институт
[НИФХИ]	Научно-исследовательский физико-химический институт имени Л. Я. Карпова
[НовГУ]	Новгородский государственный университет им. Ярослава Мудрого
[НТЦ НМСТ]	Научно-технологический центр «Нано- и микросистемной техники» 
[ООО НТЦ ТПТ]	ООО "НТЦ тонкопленочных технологий в энергетике"
[ООО НТЦ ТПТ]	ООО «НТЦ тонкопленочных технологий в энергетике»
[ПГНИУ]	Пермский государственный национальный исследовательский университет
[ПГУ, Белоруссия]	Полоцкий государственный университет, Белоруссия
[ПетрГУ]	Петрозаводский государственный университет
[ПИЯФ]	Петербургский институт ядерной физики имени Б. П. Константинова
[ПНИПУ]	Пермский национальный исследовательский политехнический университет
[РГПУ]	Российский государственный педагогический университет им. А. И. Герцена
[РКЦ]	Российский квантовый центр
[РУДН]	Российский университет дружбы народов
[Самарский университет]	Самарский национальный исследовательский университет имени академика С.П. Королева
[СамГМУ]	Самарский государственный медицинский университет
[САО РАН]	Специальная астрофизическая обсерватория РАН
[САФУ им. М. В. Ломоносова]	Северный (Арктический) федеральный университет им. М. В. Ломоносова
[СГТУ]	Саратовский государственный технический университет им. Ю. А. Гагарина
[СГУ им. Н. Г. Чернышевского]	Саратовский государственный университет им. Н. Г. Чернышевскогo
[СколТех]	Сколковский институт науки и технологий
[СПБАУ РАН]	Санкт-Петербургский национальный исследовательский Академический университет имени Ж. И. Алферова Российской академии наук
[СПбГТИ]	Санкт-Петербургский государственный технологический институт
[СПбГУ]	Санкт-Петербургский государственный университет
[СПбГУТ]	Санкт-Петербургский государственный университет телекоммуникаций им. проф. М. А. Бонч-Бруевича
[СПбГЭТУ (ЛЭТИ)]	Санкт-Петербургский государственный электротехнический университет «ЛЭТИ» имени В. И. Ульянова
[СПбПУ]	Санкт-Петербургский политехнический университет Петра Великого
[СФ ИРЭ им. В. А. Котельникова РАН]	Институт радиотехники и электроники имени В. А. Котельникова РАН
[ТвГу]	Тверской государственный университет
[ТГМПИ]	Тамбовский государственный музыкально-педагогический институт имени С.В. Рахманинов 
[ТГУ]	Тамбовский государственный университет имени Г. Р. Державина
[ТИСНУМ]	Технологический институт сверхтвердых и новых углеродных материалов
[ТПУ]	Томский политехнический университет
[ТРИНИТИ]	Троицкий институт инновационных и термоядерных исследований
[УГНТУ]	Уфимский государственный нефтяной технический университет
[УГТУ-УПИ]	Уральский государственный технический университет
[УрФУ]	Уральский федеральный университет
[УЦКП СН УрФУ]	Уральский центр коллективного пользования «Современные нанотехнологии» уральского федерального университета
[ФИАН]	Физический институт им. П. Н. Лебедева РАН
[ФНКЦ ФМБА]	Федеральный научно-клинический физико-химической медицины ФМБА России
[ФТИ]	ФТИ им. А.Ф. Иоффе
[ФТИАН им. К.А. Валиева РАН]	Физико-технологический институт Российской академии наук, им. К. А. Валиева РАН
[ЮРГПУ (НПИ)]	Южно-Российский государственный политехнический университет (НПИ) имени М. И. Платова
[ЮФУ]	Южный федеральный университет
